
                                     ################
    ###########                     #                #
   #           #                    #                #
   #           #                    #                #
   #           #                   #                  #
   #           #                   #x                  ###
    #########   #                ##  x###############     #################
             #   ################    #               ##                    #
              #                     #                  #                   #
               ##                 ##                    #                  #
                 #               #                      #                  #
                 #               #                      #                  #
                 #               #                      #                  #
               ##                 #                     #    ##############
     ##########    #############   #                   ##===#
    #            ##             #   ###################    #
    #           #                #                         #
    #           #                 #                        #
    #           #                  #                       #
    #           #                  #                       #
    #           #                  #                       #
     ###########                    #                      #
                                     ######################
